R 1024 768

NO ./textures/bluestone.xpm

SO ./textures/greystone.xpm

WE ./textures/redbrick.xpm

EA ./textures/wood.xpm

S  ./textures/barrel.xpm


F  113, 113, 113
C  56, 56, 56

111111111111111111111111
100000000000000000000001
100000000000000000000001
100000000000000000000001
100000111110000101010001
100000100010000000000001
100000100010000100010001
100000100010000000000001
100000110110000101010001
100000000000000000000001
100000000000000000000001
100000000000000000000001
100000000000000000000001
100000000000000000000001
100000000000000000000001
100000000000000000000001
111111111000000000000001
110100001000000202200001
110000001000000202020001
11010000100000000E000001
110111111000000000000001
110000000000000000000001
111111111000000000000021
111111111111111111111111
